001111109999
1
001122109999
1
001144109999
4
001133109999
0
020110101469
3